WEEK_NUMBER,acq_cat,before_acq,after_acq,acq_diff,arrivals,departures,commits,comments,mergers,pullrequests,issues,arrivals_user,arrivals_dev,departures_user,departures_dev
201531,after,0,1,65,20,15,274,594,44,149,11,5,15,6,9
201535,after,0,1,69,27,17,399,568,81,124,10,2,25,1,16
201549,after,0,1,83,93,0,1540,622,1182,157,11,9,84,0,0
201604,after,0,1,91,2,0,0,128,0,0,0,2,0,0,0
201344,before,1,0,-26,8,3,440,78,93,61,1,1,7,0,3
201551,after,0,1,85,53,0,1144,579,1477,126,3,3,50,0,0
201547,after,0,1,81,99,0,1625,488,1510,152,5,4,95,0,0
201550,after,0,1,84,65,0,1186,661,1094,143,10,7,58,0,0
201528,after,0,1,62,15,12,259,612,60,127,9,8,7,7,5
201534,after,0,1,68,22,17,285,467,59,81,3,1,21,4,13
201532,after,0,1,66,16,5,309,605,72,129,4,2,14,2,3
201536,after,0,1,70,33,25,418,837,138,157,5,6,27,3,22
201527,after,0,1,61,11,10,238,429,35,114,9,1,10,3,7
201530,after,0,1,64,10,9,280,483,40,115,10,3,7,2,7
201526,after,0,1,60,7,13,249,519,29,99,9,3,4,5,8
201524,after,0,1,58,14,10,352,643,36,109,8,6,8,3,7
201525,after,0,1,59,36,29,323,525,54,145,5,6,30,7,22
201503,after,0,1,37,6,3,449,452,118,91,1,1,5,1,2
201529,after,0,1,63,19,14,289,625,47,141,6,6,13,7,7
201523,after,0,1,57,7,8,229,502,26,127,4,4,3,4,4
201520,after,0,1,54,9,7,231,674,50,106,2,4,5,3,4
201446,after,0,1,28,6,8,418,250,84,100,1,0,6,1,7
201516,after,0,1,50,9,7,208,457,31,102,3,2,7,1,6
201515,after,0,1,49,10,8,219,411,54,92,3,4,6,4,4
201502,after,0,1,36,10,4,326,368,94,100,4,3,7,1,3
201441,after,0,1,23,7,5,370,161,33,89,2,3,4,3,2
201513,after,0,1,47,8,11,237,420,46,105,5,5,3,3,8
201439,after,0,1,21,4,4,318,188,35,66,3,2,2,2,2
201512,after,0,1,46,9,6,334,638,82,155,1,0,9,2,4
201504,after,0,1,38,17,12,400,492,136,140,4,4,13,3,9
201510,after,0,1,44,11,7,366,442,68,114,15,7,4,4,3
201451,after,0,1,33,7,3,378,361,94,91,4,2,5,1,2
201436,after,0,1,18,8,3,270,120,26,63,1,2,6,1,2
201509,after,0,1,43,3,3,405,454,73,103,4,0,3,0,3
201508,after,0,1,42,7,11,260,253,60,68,6,5,2,4,7
201448,after,0,1,30,3,4,212,202,45,72,3,2,1,2,2
201435,after,0,1,17,5,6,370,159,218,93,0,1,4,2,4
201507,after,0,1,41,7,10,298,465,88,101,1,2,5,2,8
201505,after,0,1,39,11,13,338,512,69,94,4,5,6,4,9
201434,after,0,1,16,7,6,330,126,198,69,0,2,5,2,4
201433,after,0,1,15,5,2,422,100,46,72,0,0,5,0,2
201428,after,0,1,10,4,3,296,130,51,49,2,0,4,0,3
201543,after,0,1,77,117,0,1730,428,1430,146,4,6,111,0,0
201514,after,0,1,48,12,6,217,369,33,94,4,5,7,3,3
201511,after,0,1,45,13,11,342,366,101,120,3,3,10,4,7
201548,after,0,1,82,55,0,1022,680,841,107,2,6,49,0,0
201521,after,0,1,55,5,2,162,348,35,71,3,2,3,1,1
201450,after,0,1,32,6,4,391,434,60,100,1,0,6,0,4
201444,after,0,1,26,8,2,249,133,71,66,3,3,5,0,2
201423,after,0,1,5,8,7,290,96,64,54,3,3,5,2,5
201409,before,1,0,-9,0,0,358,64,18,60,0,0,0,0,0
201401,before,1,0,-17,5,6,296,67,52,45,0,1,4,2,4
201349,before,1,0,-21,4,3,553,81,47,53,0,0,4,1,2
201350,before,1,0,-20,8,2,419,99,58,38,2,0,8,0,2
201352,before,1,0,-18,3,0,251,53,20,30,2,0,3,0,0
201317,before,1,0,-53,2,2,311,43,16,21,0,1,1,0,2
201227,before,1,0,-95,41,33,1397,10,907,8,1,0,41,0,33
201240,before,1,0,-82,48,54,1512,17,1020,2,1,1,47,0,54
201404,before,1,0,-14,4,2,249,48,20,44,0,0,4,0,2
201403,before,1,0,-15,1,3,450,54,48,53,0,0,1,0,3
201542,after,0,1,76,152,0,1996,360,1816,127,1,1,151,0,0
201552,after,0,1,86,24,0,797,260,982,95,3,2,22,0,0
201541,after,0,1,75,128,0,1181,346,379,101,1,2,126,0,0
201540,after,0,1,74,54,38,688,472,84,130,2,0,54,2,36
201539,after,0,1,73,46,38,539,536,45,145,2,3,43,4,34
201538,after,0,1,72,39,18,477,439,35,132,6,7,32,4,14
201544,after,0,1,78,112,0,1575,414,1135,145,4,4,108,0,0
201603,after,0,1,90,3,0,0,90,0,0,0,3,0,0,0
201537,after,0,1,71,34,22,276,611,46,120,2,7,27,4,18
201606,after,0,1,93,1,0,0,72,0,0,0,1,0,0,0
201533,after,0,1,67,25,20,232,414,45,113,21,6,19,7,13
201609,after,0,1,96,1,0,0,27,0,0,0,1,0,0,0
201522,after,0,1,56,5,9,220,563,41,105,3,3,2,5,4
201519,after,0,1,53,2,8,299,583,33,155,0,0,2,1,7
201518,after,0,1,52,7,6,214,371,39,113,2,3,4,3,3
201517,after,0,1,51,6,6,211,333,46,95,3,2,4,2,4
201506,after,0,1,40,10,11,406,476,87,133,3,5,5,6,5
201449,after,0,1,31,7,10,407,342,84,100,4,3,4,3,7
201447,after,0,1,29,7,6,362,279,59,90,3,2,5,4,2
201431,after,0,1,13,6,5,347,91,40,76,1,4,2,3,2
201430,after,0,1,12,4,1,317,113,57,51,3,0,4,0,1
201424,after,0,1,6,3,7,228,96,18,46,0,1,2,1,6
201445,after,0,1,27,11,7,211,125,25,56,0,4,7,4,3
201442,after,0,1,24,3,1,298,138,34,72,2,0,3,0,1
201421,after,0,1,3,12,8,371,74,40,71,1,4,8,2,6
201420,after,0,1,2,2,1,284,66,17,37,1,0,2,0,1
201427,after,0,1,9,6,5,283,158,31,70,1,1,5,1,4
201418,during,0,0,0,6,3,358,81,62,52,3,0,6,0,3
201426,after,0,1,8,9,6,327,83,36,48,0,0,9,0,6
201605,after,0,1,92,1,0,0,73,0,0,0,1,0,0,0
201440,after,0,1,22,2,5,327,169,62,79,0,1,1,1,4
201416,before,1,0,-2,1,3,360,77,17,59,3,0,1,0,3
201438,after,0,1,20,6,4,329,210,75,91,2,3,3,2,2
201415,before,1,0,-3,1,1,403,83,18,78,0,1,0,0,1
201412,before,1,0,-6,3,4,391,97,39,73,4,0,3,0,4
201413,before,1,0,-5,2,2,478,76,58,62,1,0,2,0,2
201437,after,0,1,19,7,5,382,184,56,94,6,2,5,1,4
201414,before,1,0,-4,5,5,411,61,40,60,3,2,3,3,2
201411,before,1,0,-7,5,5,539,194,56,115,14,3,2,2,3
201419,after,0,1,1,5,7,535,104,142,59,1,1,4,1,6
201410,before,1,0,-8,6,5,475,100,47,93,4,1,5,1,4
201545,after,0,1,79,107,0,1726,363,907,123,1,2,105,0,0
201610,after,0,1,97,1,0,0,40,0,0,0,1,0,0,0
201553,after,0,1,87,12,0,233,75,434,33,1,1,11,0,0
201601,after,0,1,88,1,0,0,230,0,0,0,1,0,0,0
201340,before,1,0,-30,2,1,516,106,45,63,0,0,2,0,1
201339,before,1,0,-31,3,4,417,96,74,66,0,0,3,0,4
201346,before,1,0,-24,4,3,176,48,7,22,5,1,3,1,2
201348,before,1,0,-22,2,1,167,16,24,21,0,0,2,0,1
201429,after,0,1,11,3,2,419,87,23,51,0,0,3,0,2
201443,after,0,1,25,5,5,338,149,60,91,4,1,4,1,4
201452,after,0,1,34,3,3,188,151,26,45,2,1,2,1,2
201221,before,1,0,-101,31,31,1312,34,473,1,0,0,31,0,31
201323,before,1,0,-47,3,2,291,16,50,14,1,1,2,1,1
201307,before,1,0,-63,33,54,1488,23,1002,20,0,0,33,0,54
201432,after,0,1,14,6,2,387,173,48,74,4,1,5,0,2
201417,before,1,0,-1,6,2,288,69,18,40,0,1,5,0,2
201422,after,0,1,4,6,8,358,106,44,50,1,0,6,1,7
201408,before,1,0,-10,4,4,591,148,32,75,0,0,4,0,4
201405,before,1,0,-13,3,3,418,101,81,48,0,1,2,1,2
201341,before,1,0,-29,5,0,367,66,25,42,0,1,4,0,0
201345,before,1,0,-25,3,1,324,53,19,51,0,1,2,0,1
201337,before,1,0,-33,2,0,384,65,25,41,0,1,1,0,0
201546,after,0,1,80,80,0,1137,560,612,152,3,5,75,0,0
201425,after,0,1,7,19,18,234,58,32,48,0,0,19,0,18
201406,before,1,0,-12,2,3,461,67,39,33,1,0,2,1,2
201338,before,1,0,-32,3,5,375,92,26,46,0,1,2,1,4
201335,before,1,0,-35,2,3,521,54,46,44,0,0,2,0,3
201336,before,1,0,-34,2,3,317,48,36,49,0,0,2,0,3
201329,before,1,0,-41,1,0,620,25,92,27,1,0,1,0,0
201325,before,1,0,-45,4,3,379,11,58,17,0,1,3,1,2
201324,before,1,0,-46,3,2,506,14,22,14,3,0,3,1,1
201407,before,1,0,-11,3,1,471,141,35,73,0,1,2,0,1
201602,after,0,1,89,1,0,0,124,0,0,0,1,0,0,0
201334,before,1,0,-36,3,2,460,36,48,42,0,2,1,1,1
201333,before,1,0,-37,2,2,406,57,51,49,0,1,1,1,1
201332,before,1,0,-38,3,2,243,14,33,24,0,0,3,0,2
201313,before,1,0,-57,10,54,634,25,737,39,0,0,10,0,54
201312,before,1,0,-58,31,124,1471,34,1224,35,0,0,31,0,124
201315,before,1,0,-55,1,0,160,27,8,17,0,0,1,0,0
201316,before,1,0,-54,3,2,302,17,36,17,1,1,2,0,2
201314,before,1,0,-56,2,1,345,22,187,31,1,1,1,0,1
201311,before,1,0,-59,37,106,1807,21,1022,17,0,0,37,0,106
201304,before,1,0,-66,39,71,1787,11,1179,2,0,0,39,0,71
201331,before,1,0,-39,8,2,340,33,37,29,2,1,7,0,2
201330,before,1,0,-40,3,0,598,37,69,27,0,0,3,0,0
201328,before,1,0,-42,4,3,622,32,32,31,0,1,3,1,2
201327,before,1,0,-43,2,1,250,16,33,27,1,1,1,1,0
201326,before,1,0,-44,1,0,304,18,13,9,1,0,1,0,0
201322,before,1,0,-48,2,1,350,23,32,22,0,0,2,0,1
201321,before,1,0,-49,3,2,328,10,71,23,0,0,3,0,2
201320,before,1,0,-50,2,1,322,35,19,25,0,1,1,1,0
201319,before,1,0,-51,2,4,418,54,48,26,2,2,0,3,1
201310,before,1,0,-60,45,116,1407,8,1003,10,0,0,45,0,116
201309,before,1,0,-61,52,103,1593,8,608,23,0,0,52,0,103
201308,before,1,0,-62,39,107,1459,7,911,6,1,1,38,1,106
201306,before,1,0,-64,36,87,1500,5,1163,8,0,0,36,0,87
201305,before,1,0,-65,47,71,1532,2,1047,1,0,0,47,0,71
201244,before,1,0,-78,49,41,1652,2,1019,1,0,0,49,0,41
201303,before,1,0,-67,42,72,1588,8,921,4,0,0,42,0,72
201302,before,1,0,-68,44,65,1233,3,1114,3,0,0,44,0,65
201301,before,1,0,-69,25,42,944,2,469,1,0,1,24,1,41
201251,before,1,0,-71,47,63,1572,2,842,2,0,0,47,0,63
201249,before,1,0,-73,48,68,1306,5,810,0,0,0,48,0,68
201250,before,1,0,-72,43,60,1428,35,761,0,0,1,42,0,60
201248,before,1,0,-74,31,47,1605,1,1180,0,0,0,31,0,47
201246,before,1,0,-76,45,51,1685,2,1340,0,0,0,45,0,51
201247,before,1,0,-75,31,51,1642,0,1159,0,0,0,31,0,51
201245,before,1,0,-77,49,57,1487,3,1059,1,0,0,49,0,57
201243,before,1,0,-79,39,63,1720,15,1110,4,0,0,39,0,63
201242,before,1,0,-80,48,56,1357,22,627,1,3,0,48,1,55
201241,before,1,0,-81,35,50,1475,2,588,0,0,0,35,0,50
201239,before,1,0,-83,41,50,1721,7,1335,1,0,0,41,0,50
201234,before,1,0,-88,44,39,1366,11,623,0,0,0,44,0,39
201235,before,1,0,-87,48,45,1090,7,423,0,0,0,48,0,45
201233,before,1,0,-89,49,42,1343,3,808,0,0,0,49,0,42
201232,before,1,0,-90,51,30,1204,40,629,0,0,0,51,0,30
201231,before,1,0,-91,53,47,1330,3,969,0,0,0,53,0,47
201229,before,1,0,-93,48,37,1463,5,1184,1,0,0,48,0,37
201228,before,1,0,-94,62,47,1646,15,1127,4,0,0,62,0,47
201222,before,1,0,-100,64,63,1433,10,736,2,0,1,63,1,62
201218,before,1,0,-104,53,37,1471,23,808,0,0,0,53,0,37
201217,before,1,0,-105,73,38,1674,10,759,0,0,0,73,0,38
201226,before,1,0,-96,41,32,1465,0,813,2,0,0,41,0,32
201615,after,0,1,102,0,0,0,2,0,0,0,0,0,0,0
201318,before,1,0,-52,2,4,335,15,23,9,0,1,1,1,3
201238,before,1,0,-84,62,60,1732,22,1141,0,0,0,62,0,60
201225,before,1,0,-97,51,36,1387,4,831,1,3,0,51,0,36
201219,before,1,0,-103,65,35,1722,3,1273,0,0,0,65,0,35
201224,before,1,0,-98,45,33,1433,30,873,1,0,0,45,0,33
201214,before,1,0,-108,61,31,1119,0,482,0,0,0,61,0,31
201223,before,1,0,-99,53,43,1430,3,917,0,0,0,53,0,43
201213,before,1,0,-109,84,33,1309,8,836,0,0,0,84,0,33
201220,before,1,0,-102,64,42,1751,5,1556,0,0,0,64,0,42
201212,before,1,0,-110,92,44,1273,7,927,0,0,0,92,0,44
201210,before,1,0,-112,143,46,1723,7,1333,2,0,0,143,0,46
201347,before,1,0,-23,3,3,211,45,12,24,8,0,3,0,3
201215,before,1,0,-107,78,39,1391,4,1184,0,0,0,78,0,39
201343,before,1,0,-27,3,2,393,56,32,41,3,0,3,0,2
201216,before,1,0,-106,70,45,1593,9,796,0,0,0,70,0,45
201211,before,1,0,-111,86,38,1298,0,680,0,0,0,86,0,38
201402,before,1,0,-16,2,2,354,86,30,45,0,0,2,0,2
201236,before,1,0,-86,56,40,1631,6,1223,0,0,0,56,0,40
201132,before,1,0,-142,4,9,479,0,92,0,0,0,4,0,9
201130,before,1,0,-144,8,8,414,0,100,0,0,0,8,0,8
201608,after,0,1,95,0,0,0,50,0,0,0,0,0,0,0
201607,after,0,1,94,1,0,0,41,0,0,0,1,0,0,0
201501,after,0,1,35,0,1,135,108,14,31,1,0,0,1,0
201351,before,1,0,-19,2,1,449,84,42,43,0,0,2,0,1
201342,before,1,0,-28,5,2,318,82,42,57,2,0,5,0,2
201237,before,1,0,-85,34,32,1753,9,1149,2,0,0,34,0,32
201230,before,1,0,-92,29,29,1176,0,742,2,0,0,29,0,29
201209,before,1,0,-113,99,32,1144,1,632,0,0,0,99,0,32
201208,before,1,0,-114,149,48,1320,0,769,0,0,0,149,0,48
201207,before,1,0,-115,155,32,1167,5,699,0,0,0,155,0,32
201206,before,1,0,-116,98,17,926,0,4,0,0,0,98,0,17
201205,before,1,0,-117,64,10,693,7,6,0,0,0,64,0,10
201204,before,1,0,-118,48,7,415,0,4,0,0,0,48,0,7
201203,before,1,0,-119,35,4,438,9,7,0,0,0,35,0,4
201202,before,1,0,-120,35,3,399,0,20,0,0,0,35,0,3
201201,before,1,0,-121,15,4,240,3,10,1,0,0,15,0,4
201152,before,1,0,-122,7,2,160,0,8,0,0,0,7,0,2
201151,before,1,0,-123,13,4,265,5,10,2,0,0,13,0,4
201150,before,1,0,-124,16,2,274,0,129,1,0,0,16,0,2
201147,before,1,0,-127,14,1,202,0,2,1,0,1,13,1,0
201148,before,1,0,-126,15,3,280,5,8,0,0,0,15,0,3
201146,before,1,0,-128,18,1,224,0,5,0,0,0,18,0,1
201145,before,1,0,-129,13,2,304,2,22,0,0,0,13,0,2
201144,before,1,0,-130,7,2,164,1,14,0,0,0,7,0,2
201143,before,1,0,-131,5,4,200,5,2,2,0,0,5,0,4
201142,before,1,0,-132,6,3,248,1,0,0,0,0,6,0,3
201141,before,1,0,-133,5,1,168,1,10,0,0,0,5,0,1
201138,before,1,0,-136,9,2,407,4,10,1,0,0,9,0,2
201137,before,1,0,-137,9,5,181,0,6,0,0,0,9,0,5
201136,before,1,0,-138,2,1,290,0,6,0,0,0,2,0,1
201135,before,1,0,-139,6,2,338,0,7,0,0,0,6,0,2
201134,before,1,0,-140,2,3,327,0,44,0,0,0,2,0,3
201133,before,1,0,-141,4,6,434,0,21,0,0,0,4,0,6
201131,before,1,0,-143,7,7,350,0,82,0,0,0,7,0,7
201129,before,1,0,-145,2,8,418,0,109,0,0,0,2,0,8
201128,before,1,0,-146,7,4,368,0,62,0,0,0,7,0,4
201127,before,1,0,-147,5,3,265,0,34,0,0,0,5,0,3
201126,before,1,0,-148,6,3,318,0,21,0,0,0,6,0,3
201125,before,1,0,-149,6,3,446,0,80,0,0,0,6,0,3
201124,before,1,0,-150,3,2,370,0,60,0,0,0,3,0,2
201123,before,1,0,-151,7,3,495,0,86,0,0,0,7,0,3
201122,before,1,0,-152,13,7,291,0,64,0,0,0,13,0,7
201121,before,1,0,-153,4,5,332,0,42,0,0,0,4,0,5
201120,before,1,0,-154,2,3,450,0,73,0,0,0,2,0,3
201119,before,1,0,-155,3,1,270,0,37,0,0,0,3,0,1
201118,before,1,0,-156,3,1,400,0,127,0,0,0,3,0,1
201117,before,1,0,-157,6,4,383,0,69,0,0,0,6,0,4
201116,before,1,0,-158,1,1,331,0,81,0,0,0,1,0,1
201115,before,1,0,-159,5,5,341,0,76,0,0,0,5,0,5
201112,before,1,0,-162,9,4,337,0,50,0,0,0,9,0,4
201111,before,1,0,-163,4,3,389,0,62,0,0,0,4,0,3
201110,before,1,0,-164,3,2,313,0,69,0,0,0,3,0,2
201109,before,1,0,-165,9,3,355,0,93,0,0,0,9,0,3
201108,before,1,0,-166,8,3,265,0,62,0,0,0,8,0,3
201107,before,1,0,-167,1,0,221,0,62,0,0,0,1,0,0
201106,before,1,0,-168,5,5,381,0,143,0,0,0,5,0,5
201105,before,1,0,-169,1,3,427,0,72,0,0,0,1,0,3
201104,before,1,0,-170,3,2,257,0,58,0,0,0,3,0,2
201102,before,1,0,-172,7,2,261,0,60,0,0,0,7,0,2
201101,before,1,0,-173,4,1,240,0,38,0,0,0,4,0,1
201050,before,1,0,-176,1,2,228,0,68,0,0,0,1,0,2
201052,before,1,0,-174,2,1,85,0,17,0,0,0,2,0,1
201051,before,1,0,-175,1,2,90,0,17,0,0,0,1,0,2
201049,before,1,0,-177,6,4,277,0,51,0,0,0,6,0,4
201048,before,1,0,-178,3,1,247,0,66,0,0,0,3,0,1
201039,before,1,0,-187,6,5,102,0,38,0,0,0,6,0,5
201038,before,1,0,-188,4,5,206,0,26,0,0,0,4,0,5
201046,before,1,0,-180,4,2,239,0,54,0,0,0,4,0,2
201037,before,1,0,-189,3,3,201,0,11,0,0,0,3,0,3
201044,before,1,0,-182,0,0,264,0,24,0,0,0,0,0,0
201036,before,1,0,-190,5,4,195,0,66,0,0,0,5,0,4
201043,before,1,0,-183,3,3,242,0,41,0,0,0,3,0,3
201040,before,1,0,-186,5,3,185,0,21,0,0,0,5,0,3
201042,before,1,0,-184,5,1,281,0,85,0,0,0,5,0,1
201041,before,1,0,-185,2,1,147,0,16,0,0,0,2,0,1
201031,before,1,0,-195,5,6,190,0,33,0,0,0,5,0,6
201035,before,1,0,-191,2,2,92,0,18,0,0,0,2,0,2
201032,before,1,0,-194,0,3,68,0,19,0,0,0,0,0,3
201030,before,1,0,-196,4,4,225,0,111,0,0,0,4,0,4
201029,before,1,0,-197,6,5,207,0,27,0,0,0,6,0,5
201028,before,1,0,-198,3,2,126,0,20,0,0,0,3,0,2
201027,before,1,0,-199,1,1,257,0,76,0,0,0,1,0,1
201026,before,1,0,-200,2,3,266,0,92,0,0,0,2,0,3
201025,before,1,0,-201,2,0,170,0,42,0,0,0,2,0,0
201023,before,1,0,-203,7,2,311,0,85,0,0,0,7,0,2
201022,before,1,0,-204,3,2,270,0,97,0,0,0,3,0,2
201024,before,1,0,-202,4,2,170,0,56,0,0,0,4,0,2
201021,before,1,0,-205,2,1,229,0,72,0,0,0,2,0,1
201020,before,1,0,-206,6,3,197,0,94,0,0,0,6,0,3
201019,before,1,0,-207,1,2,210,0,59,0,0,0,1,0,2
201016,before,1,0,-210,3,1,184,0,47,0,0,0,3,0,1
201018,before,1,0,-208,1,3,190,0,56,0,0,0,1,0,3
201015,before,1,0,-211,4,2,172,0,45,0,0,0,4,0,2
201013,before,1,0,-213,2,1,510,0,26,0,0,0,2,0,1
201011,before,1,0,-215,4,1,254,0,42,0,0,0,4,0,1
201010,before,1,0,-216,2,4,246,0,70,0,0,0,2,0,4
201009,before,1,0,-217,1,1,235,0,59,0,0,0,1,0,1
201008,before,1,0,-218,7,5,201,0,49,0,0,0,7,0,5
201006,before,1,0,-220,11,5,267,0,79,0,0,0,11,0,5
201005,before,1,0,-221,2,2,220,0,45,0,0,0,2,0,2
201004,before,1,0,-222,2,4,178,0,81,0,0,0,2,0,4
201002,before,1,0,-224,5,3,144,0,75,0,0,0,5,0,3
200951,before,1,0,-228,0,0,186,0,80,0,0,0,0,0,0
200950,before,1,0,-229,5,1,282,0,122,0,0,0,5,0,1
200947,before,1,0,-232,3,1,277,0,23,0,0,0,3,0,1
200948,before,1,0,-231,2,2,154,0,7,0,0,0,2,0,2
200946,before,1,0,-233,1,0,234,0,85,0,0,0,1,0,0
200945,before,1,0,-234,2,0,165,0,11,0,0,0,2,0,0
200944,before,1,0,-235,3,4,297,0,177,0,0,0,3,0,4
200943,before,1,0,-236,4,3,323,0,20,0,0,0,4,0,3
200942,before,1,0,-237,3,1,308,0,95,0,0,0,3,0,1
200941,before,1,0,-238,2,1,455,0,234,0,0,0,2,0,1
200940,before,1,0,-239,5,4,304,0,36,0,0,0,5,0,4
200939,before,1,0,-240,2,1,329,0,41,0,0,0,2,0,1
200938,before,1,0,-241,1,0,311,0,79,0,0,0,1,0,0
200937,before,1,0,-242,4,2,283,0,149,0,0,0,4,0,2
200936,before,1,0,-243,5,0,287,0,44,0,0,0,5,0,0
200935,before,1,0,-244,0,1,226,0,146,0,0,0,0,0,1
200934,before,1,0,-245,6,4,230,0,9,0,0,0,6,0,4
200933,before,1,0,-246,2,1,235,0,150,0,0,0,2,0,1
200932,before,1,0,-247,3,4,303,0,23,0,0,0,3,0,4
200930,before,1,0,-249,4,2,245,0,47,0,0,0,4,0,2
200929,before,1,0,-250,6,3,282,0,64,0,0,0,6,0,3
200928,before,1,0,-251,1,2,230,0,80,0,0,0,1,0,2
200927,before,1,0,-252,6,2,202,0,98,0,0,0,6,0,2
200925,before,1,0,-254,7,5,312,0,71,0,0,0,7,0,5
200926,before,1,0,-253,6,2,317,0,53,0,0,0,6,0,2
200924,before,1,0,-255,4,4,298,0,43,0,0,0,4,0,4
200923,before,1,0,-256,3,3,217,0,18,0,0,0,3,0,3
200922,before,1,0,-257,1,0,168,0,28,0,0,0,1,0,0
200921,before,1,0,-258,6,1,236,0,43,0,0,0,6,0,1
200920,before,1,0,-259,4,2,212,0,38,0,0,0,4,0,2
200919,before,1,0,-260,5,2,165,0,28,0,0,0,5,0,2
200918,before,1,0,-261,10,3,232,0,65,0,0,0,10,0,3
200917,before,1,0,-262,8,5,221,0,12,0,0,0,8,0,5
200916,before,1,0,-263,1,3,236,0,3,0,0,0,1,0,3
200915,before,1,0,-264,2,1,231,0,0,0,0,0,2,0,1
200914,before,1,0,-265,1,2,323,0,13,0,0,0,1,0,2
200913,before,1,0,-266,2,1,284,0,6,0,0,0,2,0,1
200912,before,1,0,-267,2,1,221,0,20,0,0,0,2,0,1
200911,before,1,0,-268,1,1,380,0,4,0,0,0,1,0,1
200910,before,1,0,-269,2,1,375,0,2,0,0,0,2,0,1
200909,before,1,0,-270,0,0,227,0,9,0,0,0,0,0,0
200908,before,1,0,-271,1,1,96,0,4,0,0,0,1,0,1
200907,before,1,0,-272,0,1,114,0,5,0,0,0,0,0,1
200905,before,1,0,-274,1,0,258,0,0,0,0,0,1,0,0
200904,before,1,0,-275,3,0,207,0,3,0,0,0,3,0,0
200902,before,1,0,-277,0,4,247,0,4,0,0,0,0,0,4
200903,before,1,0,-276,2,1,300,0,24,0,0,0,2,0,1
200901,before,1,0,-278,1,1,127,0,14,0,0,0,1,0,1
200852,before,1,0,-279,0,0,110,0,5,0,0,0,0,0,0
200851,before,1,0,-280,2,2,250,0,9,0,0,0,2,0,2
200850,before,1,0,-281,3,1,288,0,14,0,0,0,3,0,1
200849,before,1,0,-282,2,2,361,0,23,0,0,0,2,0,2
200848,before,1,0,-283,1,1,221,0,22,0,0,0,1,0,1
200847,before,1,0,-284,1,0,310,0,10,0,0,0,1,0,0
200846,before,1,0,-285,2,2,251,0,10,0,0,0,2,0,2
200845,before,1,0,-286,1,0,224,0,9,0,0,0,1,0,0
200844,before,1,0,-287,3,1,248,0,26,0,0,0,3,0,1
200843,before,1,0,-288,1,0,198,0,9,0,0,0,1,0,0
200842,before,1,0,-289,1,1,196,0,6,0,0,0,1,0,1
200841,before,1,0,-290,1,2,156,0,7,0,0,0,1,0,2
200840,before,1,0,-291,0,0,234,0,11,0,0,0,0,0,0
200837,before,1,0,-294,6,2,183,0,21,0,0,0,6,0,2
200838,before,1,0,-293,2,1,145,0,1,0,0,0,2,0,1
201103,before,1,0,-171,2,1,240,0,61,0,0,0,2,0,1
201014,before,1,0,-212,4,2,316,0,62,0,0,0,4,0,2
201007,before,1,0,-219,8,2,206,0,86,0,0,0,8,0,2
201001,before,1,0,-225,4,3,136,0,33,0,0,0,4,0,3
200953,before,1,0,-226,3,0,21,0,5,0,0,0,3,0,0
201252,before,1,0,-70,20,23,685,1,254,1,0,0,20,0,23
201140,before,1,0,-134,3,3,331,2,6,1,0,0,3,0,3
201149,before,1,0,-125,18,4,212,0,18,0,0,0,18,0,4
201139,before,1,0,-135,7,3,270,0,12,0,0,0,7,0,3
201114,before,1,0,-160,6,2,252,0,103,0,0,0,6,0,2
201113,before,1,0,-161,5,4,342,0,95,0,0,0,5,0,4
201045,before,1,0,-181,6,4,227,0,19,0,0,0,6,0,4
201047,before,1,0,-179,5,2,196,0,40,0,0,0,5,0,2
201033,before,1,0,-193,2,2,149,0,28,0,0,0,2,0,2
201034,before,1,0,-192,2,1,145,0,13,0,0,0,2,0,1
201017,before,1,0,-209,4,1,200,0,60,0,0,0,4,0,1
201012,before,1,0,-214,9,7,303,0,50,0,0,0,9,0,7
200952,before,1,0,-227,3,1,121,0,39,0,0,0,3,0,1
200949,before,1,0,-230,1,0,210,0,244,0,0,0,1,0,0
200931,before,1,0,-248,4,3,256,0,109,0,0,0,4,0,3
200839,before,1,0,-292,3,1,97,0,24,0,0,0,3,0,1
200834,before,1,0,-297,1,2,229,0,7,0,0,0,1,0,2
200835,before,1,0,-296,1,1,66,0,13,0,0,0,1,0,1
200833,before,1,0,-298,2,1,175,0,16,0,0,0,2,0,1
200832,before,1,0,-299,1,1,157,0,2,0,0,0,1,0,1
200831,before,1,0,-300,1,1,209,0,7,0,0,0,1,0,1
200830,before,1,0,-301,2,2,173,0,10,0,0,0,2,0,2
200828,before,1,0,-303,2,1,91,0,3,0,0,0,2,0,1
200827,before,1,0,-304,1,1,156,0,4,0,0,0,1,0,1
200826,before,1,0,-305,1,0,52,0,7,0,0,0,1,0,0
200825,before,1,0,-306,2,1,154,0,4,0,0,0,2,0,1
200824,before,1,0,-307,1,1,128,0,5,0,0,0,1,0,1
200823,before,1,0,-308,2,2,179,0,12,0,0,0,2,0,2
200822,before,1,0,-309,0,0,182,0,4,0,0,0,0,0,0
200821,before,1,0,-310,2,2,261,0,7,0,0,0,2,0,2
200820,before,1,0,-311,1,0,236,0,13,0,0,0,1,0,0
200819,before,1,0,-312,0,0,271,0,16,0,0,0,0,0,0
200818,before,1,0,-313,1,0,250,0,17,0,0,0,1,0,0
200817,before,1,0,-314,2,1,157,0,8,0,0,0,2,0,1
200816,before,1,0,-315,0,1,192,0,0,0,0,0,0,0,1
200815,before,1,0,-316,2,3,212,0,2,0,0,0,2,0,3
200814,before,1,0,-317,1,1,171,0,10,0,0,0,1,0,1
200813,before,1,0,-318,0,1,209,0,14,0,0,0,0,0,1
200812,before,1,0,-319,2,2,155,0,22,0,0,0,2,0,2
200811,before,1,0,-320,1,0,171,0,25,0,0,0,1,0,0
200810,before,1,0,-321,4,2,154,0,16,0,0,0,4,0,2
200809,before,1,0,-322,2,0,107,0,19,0,0,0,2,0,0
200805,before,1,0,-326,2,1,152,0,15,0,0,0,2,0,1
200808,before,1,0,-323,3,2,32,0,14,0,0,0,3,0,2
200807,before,1,0,-324,3,1,29,0,9,0,0,0,3,0,1
200804,before,1,0,-327,3,1,133,0,5,0,0,0,3,0,1
200803,before,1,0,-328,4,3,165,0,9,0,0,0,4,0,3
200802,before,1,0,-329,4,4,123,0,24,0,0,0,4,0,4
200801,before,1,0,-330,5,1,117,0,13,0,0,0,5,0,1
200752,before,1,0,-331,1,1,67,0,5,0,0,0,1,0,1
200751,before,1,0,-332,3,2,194,0,28,0,0,0,3,0,2
200742,before,1,0,-341,1,0,105,0,8,0,0,0,1,0,0
200741,before,1,0,-342,4,2,180,0,12,0,0,0,4,0,2
200739,before,1,0,-344,0,0,150,0,0,0,0,0,0,0,0
200740,before,1,0,-343,2,0,91,0,6,0,0,0,2,0,0
200737,before,1,0,-346,0,1,113,0,2,0,0,0,0,0,1
200736,before,1,0,-347,1,1,72,0,22,0,0,0,1,0,1
200735,before,1,0,-348,0,0,153,0,0,0,0,0,0,0,0
200734,before,1,0,-349,2,0,151,0,7,0,0,0,2,0,0
200733,before,1,0,-350,3,2,77,0,16,0,0,0,3,0,2
200732,before,1,0,-351,1,0,78,0,4,0,0,0,1,0,0
200731,before,1,0,-352,1,0,100,0,3,0,0,0,1,0,0
200730,before,1,0,-353,0,1,66,0,1,0,0,0,0,0,1
200729,before,1,0,-354,0,0,76,0,2,0,0,0,0,0,0
200728,before,1,0,-355,0,0,51,0,0,0,0,0,0,0,0
200727,before,1,0,-356,2,1,59,0,6,0,0,0,2,0,1
200726,before,1,0,-357,0,0,66,0,0,0,0,0,0,0,0
200725,before,1,0,-358,2,1,83,0,6,0,0,0,2,0,1
200724,before,1,0,-359,0,0,30,0,0,0,0,0,0,0,0
200723,before,1,0,-360,1,0,109,0,1,0,0,0,1,0,0
200722,before,1,0,-361,0,0,83,0,7,0,0,0,0,0,0
200721,before,1,0,-362,0,1,82,0,1,0,0,0,0,0,1
200720,before,1,0,-363,3,1,51,0,3,0,0,0,3,0,1
200713,before,1,0,-370,1,3,111,0,0,0,0,0,1,0,3
200718,before,1,0,-365,1,0,44,0,0,0,0,0,1,0,0
200717,before,1,0,-366,2,0,53,0,1,0,0,0,2,0,0
200715,before,1,0,-368,0,0,43,0,0,0,0,0,0,0,0
200714,before,1,0,-369,0,1,87,0,0,0,0,0,0,0,1
200712,before,1,0,-371,1,1,145,0,0,0,0,0,1,0,1
200711,before,1,0,-372,1,1,141,0,0,0,0,0,1,0,1
200710,before,1,0,-373,1,0,103,0,0,0,0,0,1,0,0
200709,before,1,0,-374,1,1,106,0,0,0,0,0,1,0,1
200708,before,1,0,-375,0,0,78,0,0,0,0,0,0,0,0
200707,before,1,0,-376,1,1,72,0,0,0,0,0,1,0,1
200706,before,1,0,-377,0,0,98,0,0,0,0,0,0,0,0
200705,before,1,0,-378,1,0,112,0,0,0,0,0,1,0,0
200704,before,1,0,-379,2,2,108,0,0,0,0,0,2,0,2
200702,before,1,0,-381,0,0,41,0,0,0,0,0,0,0,0
200650,before,1,0,-385,0,0,67,0,0,0,0,0,0,0,0
200703,before,1,0,-380,0,0,71,0,0,0,0,0,0,0,0
200649,before,1,0,-386,2,1,60,0,0,0,0,0,2,0,1
200648,before,1,0,-387,1,1,61,0,0,0,0,0,1,0,1
200647,before,1,0,-388,0,0,62,0,0,0,0,0,0,0,0
200642,before,1,0,-393,1,0,44,0,0,0,0,0,1,0,0
200646,before,1,0,-389,0,0,30,0,0,0,0,0,0,0,0
200641,before,1,0,-394,1,0,57,0,0,0,0,0,1,0,0
200645,before,1,0,-390,0,1,26,0,0,0,0,0,0,0,1
200644,before,1,0,-391,1,1,61,0,0,0,0,0,1,0,1
200643,before,1,0,-392,0,0,43,0,0,0,0,0,0,0,0
200640,before,1,0,-395,2,1,78,0,0,0,0,0,2,0,1
200829,before,1,0,-302,2,1,71,0,8,0,0,0,2,0,1
200749,before,1,0,-334,2,2,155,0,19,0,0,0,2,0,2
200748,before,1,0,-335,1,2,160,0,6,0,0,0,1,0,2
200750,before,1,0,-333,0,1,57,0,29,0,0,0,0,0,1
200747,before,1,0,-336,0,0,131,0,2,0,0,0,0,0,0
200746,before,1,0,-337,0,0,153,0,3,0,0,0,0,0,0
200744,before,1,0,-339,3,2,111,0,4,0,0,0,3,0,2
200743,before,1,0,-340,2,1,113,0,12,0,0,0,2,0,1
200745,before,1,0,-338,0,1,187,0,31,0,0,0,0,0,1
201614,after,0,1,101,1,0,0,6,0,0,0,1,0,0,0
201612,after,0,1,99,1,0,0,11,0,0,0,1,0,0,0
201613,after,0,1,100,0,0,0,3,0,0,0,0,0,0,0
201003,before,1,0,-223,4,2,113,0,56,0,0,0,4,0,2
201611,after,0,1,98,1,0,0,6,0,0,0,1,0,0,0
200117,before,1,0,-679,1,0,1,0,0,0,0,0,1,0,0
200101,before,1,0,-695,1,0,1,0,0,0,0,0,1,0,0
200806,before,1,0,-325,0,0,29,0,2,0,0,0,0,0,0
200716,before,1,0,-367,0,0,51,0,0,0,0,0,0,0,0
200639,before,1,0,-396,0,0,58,0,0,0,0,0,0,0,0
200638,before,1,0,-397,1,0,71,0,0,0,0,0,1,0,0
200609,before,1,0,-426,0,1,105,0,0,0,0,0,0,0,1
200637,before,1,0,-398,1,0,77,0,0,0,0,0,1,0,0
200608,before,1,0,-427,0,0,62,0,0,0,0,0,0,0,0
200634,before,1,0,-401,0,0,57,0,0,0,0,0,0,0,0
200636,before,1,0,-399,0,0,68,0,0,0,0,0,0,0,0
200633,before,1,0,-402,1,1,87,0,0,0,0,0,1,0,1
200635,before,1,0,-400,0,0,87,0,0,0,0,0,0,0,0
200632,before,1,0,-403,0,0,30,0,0,0,0,0,0,0,0
200631,before,1,0,-404,0,0,41,0,0,0,0,0,0,0,0
200630,before,1,0,-405,0,0,6,0,0,0,0,0,0,0,0
200629,before,1,0,-406,0,0,19,0,0,0,0,0,0,0,0
200628,before,1,0,-407,0,0,67,0,0,0,0,0,0,0,0
200626,before,1,0,-409,0,0,93,0,0,0,0,0,0,0,0
200624,before,1,0,-411,0,0,45,0,0,0,0,0,0,0,0
200620,before,1,0,-415,0,0,16,0,0,0,0,0,0,0,0
200619,before,1,0,-416,0,2,30,0,0,0,0,0,0,0,2
200614,before,1,0,-421,0,0,26,0,0,0,0,0,0,0,0
200613,before,1,0,-422,0,0,8,0,0,0,0,0,0,0,0
200612,before,1,0,-423,0,0,19,0,0,0,0,0,0,0,0
200618,before,1,0,-417,1,0,47,0,0,0,0,0,1,0,0
200617,before,1,0,-418,0,0,48,0,0,0,0,0,0,0,0
200616,before,1,0,-419,0,0,28,0,0,0,0,0,0,0,0
200615,before,1,0,-420,0,0,24,0,0,0,0,0,0,0,0
200607,before,1,0,-428,0,0,65,0,0,0,0,0,0,0,0
200606,before,1,0,-429,0,0,72,0,0,0,0,0,0,0,0
200605,before,1,0,-430,1,0,47,0,0,0,0,0,1,0,0
200603,before,1,0,-432,0,0,6,0,0,0,0,0,0,0,0
200601,before,1,0,-434,0,0,31,0,0,0,0,0,0,0,0
200552,before,1,0,-435,0,0,37,0,0,0,0,0,0,0,0
200550,before,1,0,-437,0,0,56,0,0,0,0,0,0,0,0
200549,before,1,0,-438,0,0,29,0,0,0,0,0,0,0,0
200551,before,1,0,-436,0,0,21,0,0,0,0,0,0,0,0
200548,before,1,0,-439,0,0,20,0,0,0,0,0,0,0,0
200546,before,1,0,-441,0,0,25,0,0,0,0,0,0,0,0
200537,before,1,0,-450,0,0,18,0,0,0,0,0,0,0,0
200543,before,1,0,-444,0,0,29,0,0,0,0,0,0,0,0
200542,before,1,0,-445,0,0,4,0,0,0,0,0,0,0,0
200541,before,1,0,-446,0,0,2,0,0,0,0,0,0,0,0
200540,before,1,0,-447,0,0,2,0,0,0,0,0,0,0,0
200538,before,1,0,-449,0,0,11,0,0,0,0,0,0,0,0
200528,before,1,0,-459,0,0,29,0,0,0,0,0,0,0,0
200527,before,1,0,-460,0,0,79,0,0,0,0,0,0,0,0
200526,before,1,0,-461,1,0,104,0,0,0,0,0,1,0,0
200525,before,1,0,-462,1,1,30,0,0,0,0,0,1,0,1
200524,before,1,0,-463,0,0,65,0,0,0,0,0,0,0,0
200523,before,1,0,-464,0,0,47,0,0,0,0,0,0,0,0
200522,before,1,0,-465,0,0,69,0,0,0,0,0,0,0,0
200521,before,1,0,-466,0,0,21,0,0,0,0,0,0,0,0
200520,before,1,0,-467,0,0,27,0,0,0,0,0,0,0,0
200519,before,1,0,-468,0,0,29,0,0,0,0,0,0,0,0
200518,before,1,0,-469,0,1,34,0,0,0,0,0,0,0,1
200517,before,1,0,-470,3,0,69,0,0,0,0,0,3,0,0
200515,before,1,0,-472,0,0,18,0,0,0,0,0,0,0,0
200445,before,1,0,-495,0,0,6,0,0,0,0,0,0,0,0
200443,before,1,0,-497,0,0,3,0,0,0,0,0,0,0,0
200442,before,1,0,-498,0,0,16,0,0,0,0,0,0,0,0
200514,before,1,0,-473,0,0,49,0,0,0,0,0,0,0,0
200441,before,1,0,-499,0,0,37,0,0,0,0,0,0,0,0
200440,before,1,0,-500,0,0,31,0,0,0,0,0,0,0,0
200435,before,1,0,-505,0,0,23,0,0,0,0,0,0,0,0
200513,before,1,0,-474,0,0,4,0,0,0,0,0,0,0,0
200506,before,1,0,-481,0,0,33,0,0,0,0,0,0,0,0
200504,before,1,0,-483,0,0,25,0,0,0,0,0,0,0,0
200434,before,1,0,-506,0,0,17,0,0,0,0,0,0,0,0
200502,before,1,0,-485,0,0,19,0,0,0,0,0,0,0,0
200447,before,1,0,-493,0,0,8,0,0,0,0,0,0,0,0
200446,before,1,0,-494,0,0,23,0,0,0,0,0,0,0,0
200432,before,1,0,-508,0,0,42,0,0,0,0,0,0,0,0
200433,before,1,0,-507,0,0,28,0,0,0,0,0,0,0,0
200431,before,1,0,-509,0,0,49,0,0,0,0,0,0,0,0
200430,before,1,0,-510,0,0,19,0,0,0,0,0,0,0,0
200429,before,1,0,-511,0,0,40,0,0,0,0,0,0,0,0
200428,before,1,0,-512,0,0,60,0,0,0,0,0,0,0,0
200427,before,1,0,-513,0,0,7,0,0,0,0,0,0,0,0
200426,before,1,0,-514,2,0,41,0,0,0,0,0,2,0,0
200532,before,1,0,-455,0,0,6,0,0,0,0,0,0,0,0
200531,before,1,0,-456,0,0,9,0,0,0,0,0,0,0,0
200530,before,1,0,-457,0,0,8,0,0,0,0,0,0,0,0
200529,before,1,0,-458,0,0,31,0,0,0,0,0,0,0,0
200516,before,1,0,-471,0,0,35,0,0,0,0,0,0,0,0
200535,before,1,0,-452,0,0,13,0,0,0,0,0,0,0,0
200533,before,1,0,-454,0,1,23,0,0,0,0,0,0,0,1
200738,before,1,0,-345,3,1,50,0,4,0,0,0,3,0,1
200906,before,1,0,-273,1,0,97,0,18,0,0,0,1,0,0
200836,before,1,0,-295,0,1,76,0,10,0,0,0,0,0,1
200719,before,1,0,-364,1,0,47,0,2,0,0,0,1,0,0
200701,before,1,0,-382,0,0,68,0,0,0,0,0,0,0,0
200652,before,1,0,-383,0,0,29,0,0,0,0,0,0,0,0
200651,before,1,0,-384,0,0,42,0,0,0,0,0,0,0,0
200627,before,1,0,-408,1,0,79,0,0,0,0,0,1,0,0
200621,before,1,0,-414,0,0,16,0,0,0,0,0,0,0,0
200623,before,1,0,-412,0,0,3,0,0,0,0,0,0,0,0
200622,before,1,0,-413,0,0,4,0,0,0,0,0,0,0,0
200611,before,1,0,-424,0,0,3,0,0,0,0,0,0,0,0
200610,before,1,0,-425,0,0,16,0,0,0,0,0,0,0,0
200625,before,1,0,-410,1,0,35,0,0,0,0,0,1,0,0
200604,before,1,0,-431,0,0,1,0,0,0,0,0,0,0,0
200602,before,1,0,-433,0,0,2,0,0,0,0,0,0,0,0
200544,before,1,0,-443,0,0,14,0,0,0,0,0,0,0,0
200536,before,1,0,-451,0,0,3,0,0,0,0,0,0,0,0
200534,before,1,0,-453,0,0,2,0,0,0,0,0,0,0,0
200510,before,1,0,-477,0,0,16,0,0,0,0,0,0,0,0
200509,before,1,0,-478,0,0,17,0,0,0,0,0,0,0,0
200505,before,1,0,-482,0,0,10,0,0,0,0,0,0,0,0
200453,before,1,0,-487,0,0,1,0,0,0,0,0,0,0,0
200452,before,1,0,-488,0,0,1,0,0,0,0,0,0,0,0
200449,before,1,0,-491,0,0,6,0,0,0,0,0,0,0,0
200450,before,1,0,-490,0,0,15,0,0,0,0,0,0,0,0
200439,before,1,0,-501,0,0,1,0,0,0,0,0,0,0,0
200438,before,1,0,-502,0,0,13,0,0,0,0,0,0,0,0
200436,before,1,0,-504,0,0,6,0,0,0,0,0,0,0,0
200425,before,1,0,-515,0,0,28,0,0,0,0,0,0,0,0
200423,before,1,0,-517,0,0,39,0,0,0,0,0,0,0,0
200420,before,1,0,-520,0,0,16,0,0,0,0,0,0,0,0
200419,before,1,0,-521,0,0,21,0,0,0,0,0,0,0,0
200418,before,1,0,-522,0,1,21,0,0,0,0,0,0,0,1
200417,before,1,0,-523,0,0,36,0,0,0,0,0,0,0,0
200415,before,1,0,-525,0,0,16,0,0,0,0,0,0,0,0
200416,before,1,0,-524,0,1,12,0,0,0,0,0,0,0,1
200414,before,1,0,-526,0,0,23,0,0,0,0,0,0,0,0
200409,before,1,0,-531,0,0,16,0,0,0,0,0,0,0,0
200408,before,1,0,-532,0,0,34,0,0,0,0,0,0,0,0
200407,before,1,0,-533,0,0,1,0,0,0,0,0,0,0,0
200405,before,1,0,-535,0,0,5,0,0,0,0,0,0,0,0
200404,before,1,0,-536,0,0,22,0,0,0,0,0,0,0,0
200346,before,1,0,-546,0,0,25,0,0,0,0,0,0,0,0
200347,before,1,0,-545,0,0,13,0,0,0,0,0,0,0,0
200351,before,1,0,-541,0,0,1,0,0,0,0,0,0,0,0
200345,before,1,0,-547,0,0,17,0,0,0,0,0,0,0,0
200344,before,1,0,-548,0,0,36,0,0,0,0,0,0,0,0
200342,before,1,0,-550,0,0,3,0,0,0,0,0,0,0,0
200340,before,1,0,-552,1,0,20,0,0,0,0,0,1,0,0
200334,before,1,0,-558,0,0,4,0,0,0,0,0,0,0,0
200329,before,1,0,-563,0,0,6,0,0,0,0,0,0,0,0
200327,before,1,0,-565,0,0,22,0,0,0,0,0,0,0,0
200332,before,1,0,-560,0,0,25,0,0,0,0,0,0,0,0
200328,before,1,0,-564,0,0,22,0,0,0,0,0,0,0,0
200326,before,1,0,-566,0,0,34,0,0,0,0,0,0,0,0
200317,before,1,0,-575,0,0,3,0,0,0,0,0,0,0,0
200316,before,1,0,-576,0,0,2,0,0,0,0,0,0,0,0
200307,before,1,0,-585,0,0,1,0,0,0,0,0,0,0,0
200306,before,1,0,-586,0,0,8,0,0,0,0,0,0,0,0
200304,before,1,0,-588,0,0,2,0,0,0,0,0,0,0,0
200303,before,1,0,-589,0,0,12,0,0,0,0,0,0,0,0
200239,before,1,0,-605,0,0,7,0,0,0,0,0,0,0,0
200238,before,1,0,-606,0,0,4,0,0,0,0,0,0,0,0
200301,before,1,0,-591,0,0,4,0,0,0,0,0,0,0,0
200236,before,1,0,-608,1,1,4,0,0,0,0,0,1,0,1
200242,before,1,0,-602,0,0,7,0,0,0,0,0,0,0,0
200231,before,1,0,-613,0,0,1,0,0,0,0,0,0,0,0
200230,before,1,0,-614,0,0,1,0,0,0,0,0,0,0,0
200241,before,1,0,-603,0,0,1,0,0,0,0,0,0,0,0
200225,before,1,0,-619,0,0,1,0,0,0,0,0,0,0,0
200240,before,1,0,-604,0,0,4,0,0,0,0,0,0,0,0
200223,before,1,0,-621,0,0,1,0,0,0,0,0,0,0,0
200219,before,1,0,-625,0,0,1,0,0,0,0,0,0,0,0
200211,before,1,0,-633,0,0,8,0,0,0,0,0,0,0,0
200204,before,1,0,-640,0,0,2,0,0,0,0,0,0,0,0
200203,before,1,0,-641,0,0,2,0,0,0,0,0,0,0,0
200201,before,1,0,-643,0,0,2,0,0,0,0,0,0,0,0
200152,before,1,0,-644,0,0,1,0,0,0,0,0,0,0,0
200149,before,1,0,-647,0,0,3,0,0,0,0,0,0,0,0
200148,before,1,0,-648,1,0,1,0,0,0,0,0,1,0,0
200547,before,1,0,-440,0,0,34,0,0,0,0,0,0,0,0
200545,before,1,0,-442,0,0,13,0,0,0,0,0,0,0,0
200511,before,1,0,-476,0,0,5,0,0,0,0,0,0,0,0
200508,before,1,0,-479,0,0,8,0,0,0,0,0,0,0,0
200507,before,1,0,-480,0,0,10,0,0,0,0,0,0,0,0
200503,before,1,0,-484,0,0,13,0,0,0,0,0,0,0,0
200501,before,1,0,-486,0,0,29,0,0,0,0,0,0,0,0
200451,before,1,0,-489,0,0,5,0,0,0,0,0,0,0,0
200448,before,1,0,-492,0,0,3,0,0,0,0,0,0,0,0
200437,before,1,0,-503,0,0,1,0,0,0,0,0,0,0,0
200424,before,1,0,-516,0,0,17,0,0,0,0,0,0,0,0
200421,before,1,0,-519,0,0,51,0,0,0,0,0,0,0,0
200422,before,1,0,-518,0,0,7,0,0,0,0,0,0,0,0
200413,before,1,0,-527,0,0,7,0,0,0,0,0,0,0,0
200412,before,1,0,-528,0,0,12,0,0,0,0,0,0,0,0
200411,before,1,0,-529,0,0,12,0,0,0,0,0,0,0,0
200410,before,1,0,-530,0,0,1,0,0,0,0,0,0,0,0
200406,before,1,0,-534,0,0,12,0,0,0,0,0,0,0,0
200403,before,1,0,-537,0,1,26,0,0,0,0,0,0,0,1
200401,before,1,0,-539,0,0,55,0,0,0,0,0,0,0,0
200402,before,1,0,-538,0,0,8,0,0,0,0,0,0,0,0
200349,before,1,0,-543,0,0,4,0,0,0,0,0,0,0,0
200348,before,1,0,-544,0,0,4,0,0,0,0,0,0,0,0
200338,before,1,0,-554,0,0,10,0,0,0,0,0,0,0,0
200333,before,1,0,-559,0,0,15,0,0,0,0,0,0,0,0
200339,before,1,0,-553,0,0,1,0,0,0,0,0,0,0,0
200330,before,1,0,-562,0,0,10,0,0,0,0,0,0,0,0
200331,before,1,0,-561,0,0,2,0,0,0,0,0,0,0,0
200325,before,1,0,-567,0,0,6,0,0,0,0,0,0,0,0
200324,before,1,0,-568,0,0,32,0,0,0,0,0,0,0,0
200323,before,1,0,-569,0,0,10,0,0,0,0,0,0,0,0
200320,before,1,0,-572,0,0,6,0,0,0,0,0,0,0,0
200319,before,1,0,-573,0,0,37,0,0,0,0,0,0,0,0
200318,before,1,0,-574,0,0,22,0,0,0,0,0,0,0,0
200315,before,1,0,-577,0,0,27,0,0,0,0,0,0,0,0
200313,before,1,0,-579,0,0,26,0,0,0,0,0,0,0,0
200310,before,1,0,-582,0,0,12,0,0,0,0,0,0,0,0
200312,before,1,0,-580,0,0,13,0,0,0,0,0,0,0,0
200309,before,1,0,-583,0,0,5,0,0,0,0,0,0,0,0
200308,before,1,0,-584,2,1,8,0,0,0,0,0,2,0,1
200311,before,1,0,-581,0,0,7,0,0,0,0,0,0,0,0
200350,before,1,0,-542,0,0,1,0,0,0,0,0,0,0,0
200247,before,1,0,-597,0,0,8,0,0,0,0,0,0,0,0
200245,before,1,0,-599,0,0,4,0,0,0,0,0,0,0,0
200302,before,1,0,-590,0,0,2,0,0,0,0,0,0,0,0
200244,before,1,0,-600,0,0,3,0,0,0,0,0,0,0,0
200237,before,1,0,-607,0,0,2,0,0,0,0,0,0,0,0
200243,before,1,0,-601,0,0,5,0,0,0,0,0,0,0,0
200252,before,1,0,-592,0,0,1,0,0,0,0,0,0,0,0
200250,before,1,0,-594,0,1,5,0,0,0,0,0,0,0,1
200234,before,1,0,-610,0,0,3,0,0,0,0,0,0,0,0
200232,before,1,0,-612,0,0,4,0,0,0,0,0,0,0,0
200248,before,1,0,-596,0,0,4,0,0,0,0,0,0,0,0
200220,before,1,0,-624,0,0,1,0,0,0,0,0,0,0,0
200218,before,1,0,-626,0,0,4,0,0,0,0,0,0,0,0
200212,before,1,0,-632,0,0,6,0,0,0,0,0,0,0,0
200217,before,1,0,-627,0,0,4,0,0,0,0,0,0,0,0
200215,before,1,0,-629,0,1,9,0,0,0,0,0,0,0,1
200208,before,1,0,-636,1,0,9,0,0,0,0,0,1,0,0
200206,before,1,0,-638,0,0,3,0,0,0,0,0,0,0,0
200210,before,1,0,-634,0,0,21,0,0,0,0,0,0,0,0
200205,before,1,0,-639,0,0,2,0,0,0,0,0,0,0,0
200214,before,1,0,-630,1,0,7,0,0,0,0,0,1,0,0
200151,before,1,0,-645,1,0,1,0,0,0,0,0,1,0,0
200229,before,1,0,-615,0,0,1,0,0,0,0,0,0,0,0
200209,before,1,0,-635,0,0,1,0,0,0,0,0,0,0,0
200216,before,1,0,-628,0,0,3,0,0,0,0,0,0,0,0
200341,before,1,0,-551,0,0,2,0,0,0,0,0,0,0,0
200343,before,1,0,-549,0,0,1,0,0,0,0,0,0,0,0
200246,before,1,0,-598,0,0,2,0,0,0,0,0,0,0,0
200213,before,1,0,-631,0,0,2,0,0,0,0,0,0,0,0
200122,before,1,0,-674,0,0,9,0,0,0,0,0,0,0,0
200121,before,1,0,-675,1,1,6,0,0,0,0,0,1,0,1
200147,before,1,0,-649,0,0,2,0,0,0,0,0,0,0,0
200146,before,1,0,-650,0,0,4,0,0,0,0,0,0,0,0
200120,before,1,0,-676,0,0,4,0,0,0,0,0,0,0,0
200140,before,1,0,-656,0,0,3,0,0,0,0,0,0,0,0
200138,before,1,0,-658,0,0,1,0,0,0,0,0,0,0,0
200119,before,1,0,-677,0,0,3,0,0,0,0,0,0,0,0
200137,before,1,0,-659,0,0,1,0,0,0,0,0,0,0,0
200133,before,1,0,-663,0,0,1,0,0,0,0,0,0,0,0
200124,before,1,0,-672,0,0,2,0,0,0,0,0,0,0,0
200118,before,1,0,-678,0,0,2,0,0,0,0,0,0,0,0
200123,before,1,0,-673,0,0,6,0,0,0,0,0,0,0,0
200115,before,1,0,-681,2,1,2,0,0,0,0,0,2,0,1
