WEEK_NUMBER,acq_cat,before_acq,after_acq,acq_diff,arrivals,departures,commits,comments,mergers,pullrequests,issues,arrivals_user,arrivals_dev,departures_user,departures_dev
201617,after,0,1,80,20,0,52,534,34,30,46,18,2,0,0
201618,after,0,1,81,1,0,0,55,0,0,0,1,0,0,0
201616,after,0,1,79,16,0,25,397,16,28,32,14,2,0,0
201615,after,0,1,78,20,0,18,372,14,19,42,18,2,0,0
201614,after,0,1,77,15,0,28,404,16,25,40,14,1,0,0
201613,after,0,1,76,22,0,27,287,21,28,41,21,1,0,0
201612,after,0,1,75,27,0,13,302,8,13,30,25,2,0,0
201611,after,0,1,74,23,0,20,508,17,25,41,17,6,0,0
201610,after,0,1,73,23,0,31,390,7,31,32,20,3,0,0
201609,after,0,1,72,18,0,20,275,14,25,34,16,2,0,0
201608,after,0,1,71,37,0,36,413,21,32,48,22,15,0,0
201607,after,0,1,70,14,0,23,391,9,35,49,13,1,0,0
201606,after,0,1,69,19,0,58,486,29,38,34,17,2,0,0
201605,after,0,1,68,17,0,16,184,12,28,36,14,3,0,0
201604,after,0,1,67,23,29,22,323,11,19,44,21,2,25,4
201603,after,0,1,66,20,28,31,339,22,33,21,17,3,21,7
201602,after,0,1,65,22,19,28,380,19,26,35,18,4,14,5
201601,after,0,1,64,17,31,18,448,9,20,42,15,2,23,8
201553,after,0,1,63,14,18,15,227,8,17,20,13,1,14,4
201552,after,0,1,62,9,8,11,166,7,23,18,8,1,7,1
201551,after,0,1,61,20,32,7,218,6,15,22,20,0,27,5
201550,after,0,1,60,15,20,17,265,14,24,34,13,2,14,6
201549,after,0,1,59,26,28,5,297,0,14,38,23,3,25,3
201548,after,0,1,58,23,28,6,215,3,15,27,20,3,24,4
201547,after,0,1,57,25,39,43,386,20,29,39,22,3,32,7
201546,after,0,1,56,25,27,24,398,23,19,35,22,3,21,6
201545,after,0,1,55,24,27,10,225,7,17,35,19,5,21,6
201544,after,0,1,54,34,35,15,355,7,20,52,30,4,30,5
201543,after,0,1,53,21,24,26,399,10,23,42,18,3,22,2
201542,after,0,1,52,27,24,36,390,16,30,46,22,5,19,5
201541,after,0,1,51,23,24,21,352,14,20,30,17,6,20,4
201540,after,0,1,50,12,15,22,254,7,15,25,10,2,13,2
201539,after,0,1,49,14,12,19,250,15,20,22,13,1,10,2
201538,after,0,1,48,12,20,36,294,15,34,33,9,3,13,7
201537,after,0,1,47,24,27,50,432,21,39,39,22,2,21,6
201536,after,0,1,46,12,32,51,500,40,35,33,11,1,22,10
201535,after,0,1,45,17,12,36,232,12,32,20,11,6,7,5
201534,after,0,1,44,18,22,57,504,27,32,32,12,6,14,8
201533,after,0,1,43,20,25,22,339,12,16,34,17,3,22,3
201532,after,0,1,42,19,20,13,338,9,14,38,16,3,16,4
201531,after,0,1,41,17,21,35,371,15,21,26,13,4,16,5
201530,after,0,1,40,23,26,23,326,15,18,29,21,2,21,5
201529,after,0,1,39,18,19,31,403,15,29,45,12,6,14,5
201528,after,0,1,38,14,19,15,200,12,12,34,10,4,15,4
201527,after,0,1,37,14,17,28,217,12,21,26,10,4,10,7
201526,after,0,1,36,22,23,25,287,9,25,38,18,4,18,5
201525,after,0,1,35,15,20,15,217,4,18,32,15,0,17,3
201524,after,0,1,34,12,16,22,288,14,15,30,12,0,13,3
201523,after,0,1,33,17,16,41,397,20,41,25,13,4,11,5
201522,after,0,1,32,16,16,13,213,10,16,23,14,2,12,4
201521,after,0,1,31,26,24,17,266,6,16,27,22,4,24,0
201520,after,0,1,30,18,19,23,311,7,23,41,15,3,14,5
201519,after,0,1,29,16,14,44,466,32,25,18,10,6,9,5
201518,after,0,1,28,15,17,32,296,21,28,30,13,2,15,2
201517,after,0,1,27,19,16,17,254,7,22,32,15,4,12,4
201516,after,0,1,26,29,25,47,357,26,47,30,19,10,16,9
201515,after,0,1,25,12,14,20,334,20,24,24,9,3,11,3
201514,after,0,1,24,21,25,42,288,14,24,45,18,3,20,5
201513,after,0,1,23,18,18,17,216,7,15,31,16,2,16,2
201512,after,0,1,22,11,11,23,199,5,20,22,7,4,8,3
201511,after,0,1,21,12,11,32,200,6,27,18,7,5,8,3
201510,after,0,1,20,14,17,22,354,21,14,32,13,1,13,4
201509,after,0,1,19,20,14,12,205,2,5,31,16,4,14,0
201508,after,0,1,18,11,13,11,218,10,14,23,11,0,12,1
201507,after,0,1,17,15,12,18,283,8,19,32,14,1,10,2
201506,after,0,1,16,23,24,17,219,11,19,33,19,4,21,3
201505,after,0,1,15,14,13,13,235,9,16,23,11,3,13,0
201504,after,0,1,14,19,21,22,404,8,21,41,17,2,16,5
201503,after,0,1,13,11,14,25,417,11,23,44,10,1,12,2
201502,after,0,1,12,9,10,7,239,9,8,20,6,3,7,3
201501,after,0,1,11,7,14,10,151,4,16,16,5,2,12,2
201452,after,0,1,10,15,8,13,199,8,13,27,12,3,7,1
201451,after,0,1,9,13,8,15,162,3,16,32,12,1,7,1
201450,after,0,1,8,9,13,16,206,5,14,25,7,2,10,3
201449,after,0,1,7,18,19,40,459,21,40,49,15,3,14,5
201448,after,0,1,6,25,16,30,315,10,33,33,13,12,9,7
201447,after,0,1,5,15,17,20,247,13,16,32,14,1,14,3
201446,after,0,1,4,19,14,24,398,10,27,42,13,6,10,4
201445,after,0,1,3,15,12,28,314,10,20,29,10,5,11,1
201444,after,0,1,2,18,19,27,418,8,26,48,14,4,17,2
201443,after,0,1,1,14,9,12,312,8,14,43,11,3,7,2
201442,during,0,0,0,5,8,25,216,10,21,20,5,0,7,1
201441,before,1,0,-1,21,20,36,358,12,29,39,18,3,16,4
201440,before,1,0,-2,13,17,42,436,21,30,36,13,0,13,4
201439,before,1,0,-3,18,17,31,383,12,34,30,13,5,11,6
201438,before,1,0,-4,13,16,33,506,17,30,47,11,2,13,3
201437,before,1,0,-5,14,19,29,567,22,24,38,8,6,10,9
201436,before,1,0,-6,17,13,29,327,10,24,33,11,6,10,3
201435,before,1,0,-7,10,10,21,245,11,17,27,7,3,9,1
201434,before,1,0,-8,12,10,29,291,17,26,32,9,3,8,2
201433,before,1,0,-9,15,15,24,511,11,29,38,12,3,12,3
201432,before,1,0,-10,17,13,37,620,10,36,36,14,3,12,1
201431,before,1,0,-11,14,10,22,462,11,18,36,13,1,9,1
201430,before,1,0,-12,9,7,24,386,19,17,27,6,3,6,1
201429,before,1,0,-13,15,20,28,417,14,29,37,11,4,18,2
201428,before,1,0,-14,14,16,42,369,12,31,40,10,4,12,4
201427,before,1,0,-15,15,11,36,415,23,26,38,15,0,11,0
201426,before,1,0,-16,9,13,32,398,13,32,31,8,1,11,2
201425,before,1,0,-17,14,10,42,497,25,38,43,10,4,8,2
201424,before,1,0,-18,14,10,35,428,18,36,36,12,2,9,1
201423,before,1,0,-19,13,10,44,630,15,44,48,13,0,9,1
201422,before,1,0,-20,9,10,38,407,13,30,39,8,1,9,1
201421,before,1,0,-21,9,10,38,339,7,26,42,7,2,9,1
201420,before,1,0,-22,6,6,52,405,19,29,37,5,1,6,0
201419,before,1,0,-23,7,9,38,417,18,35,31,7,0,9,0
201418,before,1,0,-24,14,10,44,425,16,28,20,11,3,8,2
201417,before,1,0,-25,13,8,42,619,19,29,42,11,2,5,3
201416,before,1,0,-26,9,7,15,290,2,14,23,6,3,6,1
201415,before,1,0,-27,9,9,28,417,12,21,31,8,1,7,2
201414,before,1,0,-28,25,19,43,484,12,34,47,18,7,16,3
201413,before,1,0,-29,12,12,31,297,8,21,31,9,3,11,1
201412,before,1,0,-30,10,10,21,316,8,19,22,9,1,8,2
201411,before,1,0,-31,10,10,37,514,11,32,40,8,2,9,1
201410,before,1,0,-32,11,10,29,412,12,21,38,10,1,8,2
201409,before,1,0,-33,12,12,24,294,11,22,43,11,1,11,1
201408,before,1,0,-34,8,15,66,483,16,47,36,6,2,11,4
201407,before,1,0,-35,15,11,45,499,10,27,34,12,3,10,1
201406,before,1,0,-36,9,12,68,403,30,26,54,7,2,9,3
201405,before,1,0,-37,9,12,124,460,17,55,45,5,4,9,3
201404,before,1,0,-38,8,8,85,583,27,9,15,4,4,6,2
201403,before,1,0,-39,16,15,76,662,19,47,45,11,5,9,6
201402,before,1,0,-40,16,13,30,278,6,19,34,12,4,10,3
201401,before,1,0,-41,9,6,51,434,14,31,38,8,1,5,1
201352,before,1,0,-42,5,4,17,105,3,9,19,3,2,3,1
201351,before,1,0,-43,8,6,41,318,9,31,27,5,3,5,1
201350,before,1,0,-44,10,9,14,269,3,11,29,9,1,9,0
201349,before,1,0,-45,8,8,23,255,4,14,24,6,2,6,2
201348,before,1,0,-46,6,4,23,321,6,22,24,3,3,3,1
201347,before,1,0,-47,6,6,25,262,7,18,24,4,2,6,0
201346,before,1,0,-48,12,9,19,228,3,17,33,10,2,9,0
201345,before,1,0,-49,9,7,27,384,10,22,42,7,2,5,2
201344,before,1,0,-50,9,7,35,555,9,37,35,6,3,5,2
201343,before,1,0,-51,7,4,38,511,8,32,35,6,1,2,2
201342,before,1,0,-52,7,8,35,577,15,35,40,5,2,5,3
201341,before,1,0,-53,10,11,51,636,10,36,41,8,2,7,4
201340,before,1,0,-54,9,10,61,826,12,43,42,9,0,10,0
201339,before,1,0,-55,8,11,72,987,14,54,53,7,1,10,1
201338,before,1,0,-56,13,10,55,921,18,38,48,11,2,7,3
201337,before,1,0,-57,10,5,50,520,1,35,35,8,2,5,0
201336,before,1,0,-58,8,2,34,319,5,27,19,6,2,1,1
201335,before,1,0,-59,10,6,24,456,2,22,38,9,1,6,0
201334,before,1,0,-60,8,9,7,575,0,24,43,6,2,9,0
201333,before,1,0,-61,14,7,13,416,9,18,46,9,5,7,0
201332,before,1,0,-62,11,6,33,415,8,31,50,9,2,6,0
201331,before,1,0,-63,11,11,33,643,7,23,42,8,3,10,1
201330,before,1,0,-64,26,16,51,871,3,30,53,20,6,13,3
201329,before,1,0,-65,9,9,40,561,6,35,38,9,0,9,0
201328,before,1,0,-66,6,7,47,898,11,31,52,6,0,5,2
201327,before,1,0,-67,7,4,42,463,6,32,34,5,2,4,0
201326,before,1,0,-68,8,7,40,585,7,34,48,8,0,6,1
201325,before,1,0,-69,9,8,64,988,16,36,43,6,3,8,0
201324,before,1,0,-70,13,10,81,872,9,42,62,12,1,9,1
201323,before,1,0,-71,13,9,77,1055,13,39,45,10,3,9,0
201322,before,1,0,-72,9,3,46,396,12,23,22,6,3,2,1
201321,before,1,0,-73,10,7,41,333,6,18,26,8,2,5,2
201320,before,1,0,-74,14,8,61,420,6,33,35,10,4,8,0
201319,before,1,0,-75,10,10,40,230,6,24,30,7,3,10,0
201318,before,1,0,-76,18,6,15,260,0,17,35,15,3,5,1
201317,before,1,0,-77,10,6,52,326,8,18,48,8,2,5,1
201316,before,1,0,-78,11,8,52,315,3,12,38,10,1,8,0
201315,before,1,0,-79,9,5,102,330,20,30,59,5,4,3,2
201314,before,1,0,-80,12,8,55,239,5,19,27,7,5,6,2
201313,before,1,0,-81,4,3,82,247,7,28,29,2,2,3,0
201312,before,1,0,-82,7,7,84,500,11,41,43,4,3,4,3
201311,before,1,0,-83,11,8,67,393,16,34,37,8,3,7,1
201310,before,1,0,-84,10,9,31,174,1,15,29,10,0,9,0
201309,before,1,0,-85,7,10,30,260,1,17,24,5,2,9,1
201308,before,1,0,-86,11,7,18,122,3,9,23,8,3,7,0
201307,before,1,0,-87,9,5,51,218,14,22,31,9,0,5,0
201306,before,1,0,-88,6,5,41,190,31,14,28,4,2,4,1
201305,before,1,0,-89,6,3,24,97,1,9,24,5,1,3,0
201304,before,1,0,-90,14,7,32,103,1,13,33,8,6,5,2
201303,before,1,0,-91,8,6,42,135,9,4,23,7,1,5,1
201302,before,1,0,-92,13,6,15,51,2,11,27,10,3,5,1
201301,before,1,0,-93,5,1,23,82,1,6,27,4,1,1,0
201252,before,1,0,-94,8,8,60,69,26,4,21,7,1,7,1
201251,before,1,0,-95,10,9,46,48,2,6,14,6,4,6,3
201250,before,1,0,-96,5,9,130,173,25,7,15,3,2,6,3
201249,before,1,0,-97,11,6,94,235,11,15,47,10,1,5,1
201248,before,1,0,-98,9,8,137,260,36,23,23,7,2,7,1
201247,before,1,0,-99,13,9,99,208,20,23,52,9,4,5,4
201246,before,1,0,-100,18,14,70,123,22,18,36,13,5,12,2
201245,before,1,0,-101,10,4,83,111,14,19,37,9,1,4,0
201243,before,1,0,-103,9,9,8,51,0,4,40,8,1,9,0
201240,before,1,0,-106,6,5,61,82,10,16,21,3,3,3,2
201242,before,1,0,-104,7,2,8,32,0,3,27,7,0,1,1
201244,before,1,0,-102,6,3,80,111,16,11,20,4,2,3,0
201239,before,1,0,-107,9,3,61,90,4,11,33,7,2,3,0
201238,before,1,0,-108,6,4,65,83,8,13,22,3,3,3,1
201237,before,1,0,-109,13,8,44,80,7,8,37,10,3,5,3
201236,before,1,0,-110,7,2,56,87,12,7,36,5,2,2,0
201218,before,1,0,-128,5,2,65,51,0,2,25,2,3,1,1
201211,before,1,0,-135,5,3,55,57,9,6,31,2,3,3,0
201208,before,1,0,-138,3,1,60,52,17,5,22,2,1,0,1
201204,before,1,0,-142,5,0,74,101,13,7,38,3,2,0,0
201241,before,1,0,-105,5,3,38,79,3,10,23,4,1,3,0
201217,before,1,0,-129,6,2,76,72,3,1,64,4,2,2,0
201234,before,1,0,-112,11,9,10,30,0,5,25,9,2,8,1
201232,before,1,0,-114,6,5,75,75,3,1,23,4,2,5,0
201233,before,1,0,-113,6,2,35,57,0,3,22,4,2,2,0
201228,before,1,0,-118,9,5,73,105,9,8,33,8,1,5,0
201227,before,1,0,-119,5,3,13,23,0,4,24,5,0,3,0
201215,before,1,0,-131,8,2,82,72,29,12,35,5,3,2,0
201149,before,1,0,-149,2,1,34,52,8,2,25,0,2,0,1
201150,before,1,0,-148,4,2,67,43,1,3,29,3,1,2,0
201148,before,1,0,-150,5,3,21,41,4,6,18,3,2,2,1
201216,before,1,0,-130,6,3,41,62,1,5,41,3,3,0,3
201231,before,1,0,-115,10,5,30,22,0,4,31,6,4,4,1
201230,before,1,0,-116,8,4,33,39,0,3,40,5,3,3,1
201235,before,1,0,-111,6,5,15,17,0,1,17,6,0,5,0
201229,before,1,0,-117,7,10,45,49,4,4,26,7,0,8,2
201226,before,1,0,-120,10,6,40,74,17,6,29,8,2,6,0
201225,before,1,0,-121,3,2,54,41,15,8,24,2,1,2,0
201224,before,1,0,-122,6,3,79,60,14,12,36,3,3,1,2
201223,before,1,0,-123,8,4,66,97,18,11,49,7,1,4,0
201222,before,1,0,-124,7,3,96,125,22,9,49,4,3,2,1
201221,before,1,0,-125,2,1,96,72,53,17,46,1,1,1,0
201220,before,1,0,-126,3,1,83,58,36,7,21,2,1,1,0
201219,before,1,0,-127,5,5,110,89,9,8,28,4,1,5,0
201214,before,1,0,-132,3,3,56,42,13,5,22,2,1,2,1
201210,before,1,0,-136,10,7,43,60,1,2,38,7,3,4,3
201213,before,1,0,-133,7,4,22,61,1,5,15,5,2,4,0
201212,before,1,0,-134,8,1,39,36,0,5,22,4,4,1,0
201209,before,1,0,-137,4,2,49,68,3,4,25,3,1,0,2
201207,before,1,0,-139,1,1,56,22,0,0,30,1,0,1,0
201206,before,1,0,-140,5,1,74,73,20,7,15,2,3,0,1
201205,before,1,0,-141,7,6,67,93,7,8,35,6,1,6,0
201203,before,1,0,-143,10,4,88,60,11,7,26,7,3,3,1
201202,before,1,0,-144,6,4,65,66,13,10,29,3,3,3,1
201201,before,1,0,-145,2,1,87,70,23,11,21,1,1,1,0
201151,before,1,0,-147,6,3,60,75,12,9,32,3,3,1,2
201152,before,1,0,-146,0,0,63,22,7,4,16,0,0,0,0
201147,before,1,0,-151,1,0,30,20,2,1,25,1,0,0,0
201146,before,1,0,-152,0,1,34,49,4,3,27,0,0,1,0
201145,before,1,0,-153,3,2,49,44,6,4,17,2,1,1,1
201144,before,1,0,-154,7,2,35,61,6,4,29,3,4,2,0
201143,before,1,0,-155,3,1,35,24,1,3,24,1,2,1,0
201142,before,1,0,-156,4,0,42,51,2,5,34,2,2,0,0
201141,before,1,0,-157,4,0,11,51,0,4,28,4,0,0,0
201140,before,1,0,-158,3,2,55,46,13,3,14,2,1,2,0
201139,before,1,0,-159,6,3,50,26,0,0,17,5,1,3,0
201138,before,1,0,-160,1,0,34,12,1,0,19,0,1,0,0
201137,before,1,0,-161,6,2,24,23,11,8,16,3,3,1,1
201135,before,1,0,-163,2,0,36,4,0,1,7,1,1,0,0
201136,before,1,0,-162,1,1,57,25,5,2,8,0,1,1,0
201134,before,1,0,-164,0,0,49,1,0,0,9,0,0,0,0
201131,before,1,0,-167,3,1,5,4,0,1,7,2,1,0,1
201128,before,1,0,-170,4,2,22,9,0,0,4,4,0,2,0
201130,before,1,0,-168,5,3,42,19,0,0,8,3,2,3,0
201127,before,1,0,-171,0,0,11,2,0,0,1,0,0,0,0
201126,before,1,0,-172,1,0,51,4,1,1,1,0,1,0,0
201133,before,1,0,-165,3,1,34,8,1,1,5,1,2,1,0
201125,before,1,0,-173,1,1,35,15,0,0,3,1,0,1,0
201129,before,1,0,-169,2,2,33,30,0,0,18,2,0,2,0
201132,before,1,0,-166,1,0,27,3,0,0,6,1,0,0,0
201122,before,1,0,-176,0,0,13,5,0,0,5,0,0,0,0
201124,before,1,0,-174,0,0,30,4,0,0,0,0,0,0,0
201102,before,1,0,-196,1,0,6,5,0,0,4,1,0,0,0
201104,before,1,0,-194,0,0,1,2,0,0,1,0,0,0,0
201107,before,1,0,-191,0,0,14,7,0,0,0,0,0,0,0
201101,before,1,0,-197,1,0,11,1,0,0,2,1,0,0,0
201118,before,1,0,-180,0,0,8,3,0,0,1,0,0,0,0
201051,before,1,0,-199,1,1,1,8,0,0,3,1,0,1,0
201117,before,1,0,-181,0,0,2,0,0,0,4,0,0,0,0
201052,before,1,0,-198,0,0,1,2,0,0,0,0,0,0,0
201050,before,1,0,-200,1,0,8,16,0,0,1,1,0,0,0
201046,before,1,0,-204,1,0,0,2,0,0,2,1,0,0,0
201112,before,1,0,-186,0,0,2,2,0,1,0,0,0,0,0
201111,before,1,0,-187,0,0,4,4,0,0,0,0,0,0,0
201042,before,1,0,-208,0,0,0,0,0,0,1,0,0,0,0
201109,before,1,0,-189,1,1,4,6,0,1,0,0,1,1,0
201041,before,1,0,-209,0,0,10,0,0,0,5,0,0,0,0
201108,before,1,0,-190,1,0,1,2,0,1,1,1,0,0,0
201103,before,1,0,-195,0,1,5,3,0,0,2,0,0,1,0
201049,before,1,0,-201,0,0,8,6,0,0,0,0,0,0,0
201039,before,1,0,-211,2,1,7,5,0,0,12,2,0,1,0
201120,before,1,0,-178,0,0,10,2,0,0,1,0,0,0,0
201123,before,1,0,-175,0,0,38,0,0,0,0,0,0,0,0
201119,before,1,0,-179,0,0,8,0,0,0,0,0,0,0,0
201121,before,1,0,-177,0,0,9,0,0,0,0,0,0,0,0
201116,before,1,0,-182,0,0,12,0,0,0,0,0,0,0,0
201115,before,1,0,-183,0,0,5,0,0,0,0,0,0,0,0
201105,before,1,0,-193,0,0,4,0,0,0,0,0,0,0,0
201110,before,1,0,-188,0,0,3,0,0,0,0,0,0,0,0
201038,before,1,0,-212,0,0,1,0,0,0,0,0,0,0,0
201047,before,1,0,-203,0,0,7,0,0,0,0,0,0,0,0
201037,before,1,0,-213,0,0,2,0,0,0,0,0,0,0,0
201035,before,1,0,-215,0,0,2,0,0,0,0,0,0,0,0
201028,before,1,0,-222,0,0,2,0,0,0,0,0,0,0,0
201025,before,1,0,-225,0,0,2,0,0,0,0,0,0,0,0
201045,before,1,0,-205,0,0,1,0,0,0,0,0,0,0,0
201022,before,1,0,-228,0,0,6,0,0,0,0,0,0,0,0
201015,before,1,0,-235,0,0,4,0,0,0,0,0,0,0,0
201023,before,1,0,-227,0,0,6,0,0,0,0,0,0,0,0
201014,before,1,0,-236,0,0,4,0,0,0,0,0,0,0,0
201021,before,1,0,-229,0,0,11,0,0,0,0,0,0,0,0
201007,before,1,0,-243,0,0,3,0,0,0,0,0,0,0,0
201013,before,1,0,-237,0,0,2,0,0,0,0,0,0,0,0
201012,before,1,0,-238,0,0,6,0,0,0,0,0,0,0,0
201005,before,1,0,-245,0,0,2,0,0,0,0,0,0,0,0
201004,before,1,0,-246,0,0,1,0,0,0,0,0,0,0,0
200952,before,1,0,-251,0,0,6,0,0,0,0,0,0,0,0
201003,before,1,0,-247,0,0,3,0,0,0,0,0,0,0,0
201020,before,1,0,-230,0,0,5,0,0,0,0,0,0,0,0
201011,before,1,0,-239,0,0,2,0,0,0,0,0,0,0,0
201002,before,1,0,-248,0,0,5,0,0,0,0,0,0,0,0
201010,before,1,0,-240,0,0,4,0,0,0,0,0,0,0,0
200951,before,1,0,-252,0,0,7,0,0,0,0,0,0,0,0
201019,before,1,0,-231,0,0,1,0,0,0,0,0,0,0,0
201009,before,1,0,-241,0,0,5,0,0,0,0,0,0,0,0
201018,before,1,0,-232,0,0,2,0,0,0,0,0,0,0,0
201001,before,1,0,-249,0,0,12,0,0,0,0,0,0,0,0
201017,before,1,0,-233,0,0,3,0,0,0,0,0,0,0,0
200950,before,1,0,-253,0,0,8,0,0,0,0,0,0,0,0
201016,before,1,0,-234,0,0,3,0,0,0,0,0,0,0,0
201008,before,1,0,-242,0,0,5,0,0,0,0,0,0,0,0
200949,before,1,0,-254,0,0,17,0,0,0,0,0,0,0,0
200947,before,1,0,-256,0,0,13,0,0,0,0,0,0,0,0
200953,before,1,0,-250,0,0,3,0,0,0,0,0,0,0,0
200943,before,1,0,-260,0,0,1,0,0,0,0,0,0,0,0
200941,before,1,0,-262,0,0,4,0,0,0,0,0,0,0,0
200932,before,1,0,-271,0,0,6,0,0,0,0,0,0,0,0
200948,before,1,0,-255,0,0,12,0,0,0,0,0,0,0,0
200938,before,1,0,-265,0,0,5,0,0,0,0,0,0,0,0
200931,before,1,0,-272,1,0,1,0,0,0,0,0,1,0,0
200937,before,1,0,-266,0,0,2,0,0,0,0,0,0,0,0
200936,before,1,0,-267,0,0,15,0,0,0,0,0,0,0,0
201114,before,1,0,-184,0,0,0,0,0,0,1,0,0,0,0
201040,before,1,0,-210,1,0,0,0,0,0,1,1,0,0,0
